00000000000000000000
00000000000000000000
00000000000000000000
00000000000000000000
00000000000000000000
00000000000000000000
00000000000000000000
00000000000000000000
00000000000000000000
00000000000000000000
00000000000000000000
00000000000000000000
000SSSSSSSSSSS000000
00000000000000000000
000SSSSSSSSSSSSSS000
00000000000000000000
000WWWWWWWWWWWWWW000
00000000000000000000
00000000000000000000
00000000000000000000