00000000000000000000
00000000000000000000
00000P00000000P00000
00001110000001110000
00001010000001010000
011111111BB111111110
0100000011110000P010
0100000000000BBBB010
01PBBB000E000BBBB010
01000000000000000010
01000000000000000010
010BBBBBBBBBBB000010
01000000000000000010
010BBBBBBBBBBBBBBP10
01000000000000000010
01PBBBBBBBBBBBBBB010
01000000000000000010
0100000000P000000010
01111111111111111110
00000000000000000000