WWWWW00000
W00SSSSSS0
W00S0000S0
W00S0000SW
WSSSS000S0
W000SSSSS0
W000S0S000
W000SSS00W
W00000000W
WWWWWWWWWW