0P00011111
0100010001
0110110111
00111BB100
00100P0111
P110010001
0001111111
0E01000000
0001111000
000000P000