000000000000000
WWWWWWWWW000000
00000000WWW0000
0000000000WWW00
000000000000WW0
0000000000000W0
0000000000000W0
0000000000000W0
0000000000000W0
0000000000000W0
0000000000000W0
0000000000000W0
0000000000000W0
0000000000000W0
0000000000000W0