0000000P1111100
000000000000100
000000000000100
000111111110100
000100200010100
000100000010100
000100000010100
000100000011100
000100000010000
000100000010000
000100000010000
000100000010000
P11100E0001111P
000000000000000
000000000000000