000000000000000000000000000000
WWWWWWWWWWWWWWWWWWWWWWWWWWW000
00000000000000000000000000W000
000SSSSSSSSSSSSSSS00000000WWWW
000000S0000000000S000000000000
000000S0000000000S000000000000
000000S0000000000S000000000000
000000S0000000000S000000000000
000000S0000000000S000SSSS00000
000000S0000000000SSSSS00SS0000
000000SSSSSSSS000S00S0000S0000
0000000000000SSSSS00S0000S0000
00000000000000000000S0000S0000
00000000000000000000S0000S0000
00000000000000000000S0000S0000
00000000000000000000S0000S0000
00000000000000000000SSSSSS0000
00000000000000000000S000000000
00000000000000000000S000000000
00000000000000000000S000000000