000000000000000000000000000000
000000000000000000000000000000
0001000BBBBB000000011110000000
000100000000000000P10010000000
000100000000000000010010000000
000111111110000000010010000000
000100000010000000010010000000
000P00000011111111111111111000
000000000010000000010000001000
00001111111000BBB00100BB001000
00001000001000BBB00100BB001000
0B0010000010000000010000001000
0B00100000111111111100BB001000
0B00100000100000000000BB001000
0B00100000100000000000BB001000
0B001000001P000000000E00001000
0000100000100000000000000P1000
000010000010000000000000001000
000011111111111111111111111000
000000000000000000000000000000