0000000000
0000000000
0000000000
0000000000
0000000000
0000000000
00000SSSS0
00000S00S0
00000SSSS0
0000000000