0E00000000
0000000000
1111111100
P000100100
0000000100
000B000100
000B000100
000B000P00
000B000000
0000000000