000000000000000
011111111111110
010B0B00B0B0B10
01B000BBPB0B010
010P11BB1000010
01B00111111P010
010B0P001B10010
01B000001B10010
010B11111110010
01B010010000010
010B100P0000010
01B010000000010
010B10000000010
01B011111111110
0P0000000000000