00000000
WWWWW000
0000W000
0000W000
0000W000
0000WWWW
00000000
00000000