P1111111
00000001
11111111
10000000
11111111
00000001
P1111111
00000000