WWWW00000000000WWWW0
000W00000000000000WW
000W000000000000000W
000W000000000000000W
000W000000000000000W
0000000000000000000W
0000000000000000000W
00000000000000000W0W
00000000000000000000
00000000000000000000
SSSSSSSSSSSSSSSSSS00
00000000000000000S00
00000000000000000S00
00000000000000000S00
00000000000000000S00
00000000000000000S00
00000000000000000S00
00000000000000000S00
0000000000000000SS00
00SSS0SSSSSSSSSSS000