00001110000111000000
B0001010000101000000
P1111010111101011110
00000011100001010010
000000001PB001110010
000E000000000000B010
00000111100111000010
0BBB010010010100P010
0BBB0100100101001010
00000100111101111110
000001000000000000E0
0000010000E00BBB0000
11100100000000000000
10100100111110011110
101001001BBB1001001B
1011110011101001001B
1000BBB000101001001B
1000BPB000101001001B
1111111111111111001B
000000000000000000PB